11111111111111111111111111
10010000000C00000000011111
1000011111000000000001C001
1P011E00000000000000000001
1000000000000000C000011111
10000000000000000000000001
11111000000000000000C00001
11111111111111111111111111