1111111111111111
1E00000000000001
1010010100100001
1010010010101011
1P0000000C00C001
1111111111111111